21,13
+~+++++++++++++++++++
+@@@@@+@@@@@+@@@@@@@+
+@@@@@+@@@@@+@@@@@@@+
+@+++@+@+++@+@+++++@+
+@+@@@+@@@+@@@+@+@@@+
+@+++++++@+++@+@+@+++
+@@@+@@@+@@@+@@@+@+@+
+++@+@+++@+@+++++@+@+
+@@@@@+@@@+@@@+@@@@@+
+@@@@@+@@@+@@@+@@@@@+
+@+++++@+@+++++@+++++
+@@@@@@@+@@@+@@@@@@@+
+++++++++++++++++++%+